1111111111111
1000000000001
1010000010001
1010000100001
1010001000001
1010010000001
1010100000001
1011000000001
1010100000001
1010010000001
1010001000001
1010000100001
1010000010001
1000000000001
1111111111111