1111111111111
1000000000001
101E000010001
1010000100001
1010001000001
101001000C001
1010100000001
1011000000001
1010100000001
1010010000001
1010001000001
1010000100001
1010P00010001
1000000000001
1111111111111