1111111111111
1000000000001
101E000010001
1010000100001
1010001000001
101001000C001
1010100000001
1011000P00001
1010100000001
1010010000P01
1010001000001
1010000100P01
1010P00010001
10000000000P1
1111111111111