1111111111111111
100000C000000001
1000000000000001
10E00000P0C00001
10000000E0000P01
1111111111111111