1111111
1E00001
1010001
1010001
1P00C01
1111111